----------------------------------
|                                |
|                                |
|                                |
|                                |
|                                |
|                                |
|            LEVEL 1             |
|                                |
|                                |
|                                |
|                                |
|                                |
|                                |
|                                |
----------------------------------