----------------------------------
|                                |
|                                |
|                                |
|                                |
|                                |
| --  --                         |
|      |     LEVEL 1             |
|      |                         |
|      |                         |
|      |                         |
|      --------                  |
|                                |
|                                |
|                                |
----------------------------------